1 13 31
###############################
#p     f* *  1 * 2 *  * * f   #
# # # #*# # #*#*# # # #*#*#*# #
#  x*     b**  *  1   * 2 * * #
# # # # # #*# # #*#*# # # # #*#
#f         x **  *  *   1     #
# # # #b# # # # # #*# #*# # # #
#*  *      *  *      *        #
# # # # #*# # # #*#*# # # # # #
#*    **  *       *           #
# #*# # # # # # #*# # #s# # # #
#           b   *  *          #
###############################